XXXXXXXXXXXXXXXXX
XXXXXXXXXXXXXXXXX
XXXXEXXXXX1XXXXXX
XXXXOXXXXXOXXXXXX
XXXXLXXXXXCOOXXXX
XXXXOXXXXXBXOXXXX
XXXXOXXXXXXXOXXXX
XXXXOOOXXXXXOXXXX
XXXXXXOXXXXXEXXXX
XXXXXX2XXXXXXXXXX
XXXXXXXXXXXXXXXXX

