XXXXXXXXXXXXXXXXX
XXXXXXXXXXXXXXXXX
XXXXEXOBWWX1XXXXX
XXXOOXXOWOOOOOXXX
XXXOwXXCXOWWWOXXX
XXXOwXXCXOWXXOXXX
XXXOwXXCXOWXXOXXX
XXXOCWXOXOXXXLXXX
XXXOOWXOXOWOOOXXX
XXXO2OOOXXXXEXXXX
XXXXXXXXXXXXXXXXX