XXXXXXXXXXXXXXXXX
XXXXXXWWXXXXXXXXX
XXXXOOOOXX1XXXXXX
XXOOOCCOWXOXXWWWX
XXOXXXXOWWOOsWEWX
XXOXsXXOXWXXOWOWX
XXOXOXXBXOOOOXsXX
XXOOOWXnXOXWOWOXX
XXXXCXXOXOXXWXOXX
XXXX2OOEXOLLOOOXX
XXXXXXXXXXXXXXXXX