XXXXXXXXXXXXXXXXX
XXXXXXXXXXXXXXXXX
XXXXXXXXEXXXXXXXX
XXXXXXXwOeXXXXXXX
XXXXXXXwOeXXXXXXX
XXXXXXXwOeXXXXXXX
XXXXXXXwOeXXXXXXX
XXXWXXXwOeXXXXXXX
XXW2WXXw1eXXXXXXX
XXXWXXXXXXXXXXXXX
XXXXXXXXXXXXXXXXX